48
31
0 0 0 0 0 0 0 0 0 0 0 0 0 0 0 0 0 0 0 0 0 0 0 0 0 0 0 0 0 0 0
0 0 0 0 0 0 0 0 0 0 0 0 0 0 0 0 0 0 0 0 0 0 0 0 0 0 0 0 0 0 0
0 0 0 0 0 0 0 0 0 0 0 0 0 0 0 0 0 0 0 0 0 0 0 0 0 0 0 0 0 0 0
0 0 0 0 0 0 0 0 0 0 0 0 0 0 0 0 0 0 0 0 0 0 0 0 0 0 0 0 0 0 0
0 0 0 0 0 0 0 0 0 0 0 0 0 0 0 0 0 0 0 0 0 0 0 0 0 0 0 0 0 0 0
0 0 0 0 0 0 0 0 0 0 0 0 0 0 4 4 4 4 4 0 0 0 0 0 0 0 0 0 0 0 0
0 0 0 0 0 4 4 4 3 3 1 1 4 4 4 4 4 4 4 4 4 0 0 0 0 0 0 0 0 0 0
0 0 0 0 0 4 4 4 3 3 1 1 4 4 4 4 4 4 4 4 4 0 0 0 0 0 0 0 0 0 0
0 0 0 0 0 4 4 4 3 3 1 1 0 4 4 4 0 4 4 4 4 0 0 0 0 0 0 0 0 0 0
0 0 0 0 0 4 4 4 4 4 1 1 0 4 4 4 1 0 0 0 0 0 0 0 0 0 0 0 0 0 0
0 0 0 0 0 4 4 4 4 4 2 2 0 1 1 1 1 0 0 0 0 0 0 2 2 0 0 0 0 0 0
0 0 0 0 0 1 1 1 2 2 2 2 2 1 1 1 1 0 0 0 0 0 0 2 2 2 2 2 0 0 0
0 0 0 0 0 1 1 1 2 2 2 2 2 2 4 4 4 4 0 0 0 1 1 2 2 2 2 2 0 0 0
0 0 0 4 4 4 4 4 2 2 2 2 2 2 4 4 4 4 1 1 1 1 1 1 1 1 2 2 0 0 0
0 0 0 4 4 4 4 4 2 2 2 2 2 2 4 4 4 4 1 1 1 1 1 1 1 1 0 0 0 0 0
0 0 0 4 4 4 4 4 2 2 2 2 2 2 4 4 4 4 1 1 1 1 1 1 1 1 0 0 0 0 0
0 0 0 4 4 4 0 0 0 0 1 1 1 4 4 4 4 1 1 4 4 1 1 1 4 0 0 0 0 0 0
0 0 0 4 4 4 0 0 0 0 1 1 1 4 4 4 4 1 1 4 4 1 1 4 4 4 4 0 0 0 0
0 0 0 0 0 0 0 0 0 0 1 1 1 4 4 4 4 1 1 4 4 1 1 4 4 4 4 0 0 0 0
0 0 0 0 0 0 0 0 0 0 4 4 0 4 4 4 4 1 1 1 1 1 1 1 1 0 0 0 0 0 0
0 0 0 0 0 0 0 1 1 0 0 4 0 4 4 4 4 1 1 1 1 1 1 1 1 0 0 0 0 0 0
0 0 0 0 0 3 3 1 1 4 0 4 4 4 4 4 4 4 4 4 4 1 1 1 1 0 0 0 0 0 0
0 0 0 0 0 3 3 1 0 4 0 4 4 4 6 6 6 6 4 4 4 1 1 1 1 0 0 0 0 0 0
0 0 0 0 0 4 4 0 4 4 0 1 4 4 4 4 4 4 4 4 4 1 1 4 4 4 4 0 0 0 0
0 0 0 0 0 4 4 0 0 0 1 1 1 4 4 5 4 4 4 4 1 1 1 4 4 4 4 0 0 0 0 
0 0 0 0 0 4 4 0 4 4 4 4 0 4 4 4 4 4 4 4 1 1 4 4 4 4 4 0 0 0 0 
0 0 0 0 0 0 0 0 4 4 4 4 0 4 4 6 6 6 4 1 1 4 4 4 4 4 4 0 0 0 0 
0 0 0 0 0 0 0 0 4 4 2 2 2 4 4 4 4 4 4 1 1 4 4 4 4 4 4 0 0 0 0 
0 0 0 0 0 0 0 0 4 4 2 2 2 4 4 4 4 4 4 1 1 4 4 4 4 4 4 0 0 0 0 
0 0 0 0 0 0 0 0 0 0 4 4 4 4 4 4 4 4 4 1 1 4 4 4 4 4 4 0 0 0 0 
0 0 0 0 0 0 0 0 0 0 4 4 4 4 4 4 4 4 4 1 1 4 4 4 4 4 4 0 0 0 0 
0 0 0 0 0 0 0 0 0 0 4 4 4 4 4 4 4 4 4 1 1 4 4 4 4 4 0 0 0 0 0 
0 0 0 0 0 0 0 1 1 0 4 4 4 4 4 4 4 4 4 1 1 4 4 4 4 4 0 0 0 0 0 
0 0 0 0 0 0 0 1 1 0 4 4 4 4 4 4 4 4 4 1 1 0 0 0 0 0 0 0 0 0 0 
0 0 0 0 0 0 0 1 1 0 0 0 4 4 4 4 4 4 4 0 0 0 0 0 0 0 0 0 0 0 0 
0 0 0 0 0 0 0 1 1 1 0 0 4 4 4 4 4 4 4 0 0 0 0 0 0 0 0 0 0 0 0 
0 0 0 0 0 0 0 1 1 1 0 0 4 4 4 4 4 4 4 0 0 0 0 0 0 0 0 0 0 0 0 
0 0 0 0 0 0 0 1 1 1 0 0 4 4 4 4 4 4 4 0 0 0 0 0 0 0 0 0 0 0 0 
0 0 0 0 0 0 0 1 1 1 0 0 4 4 4 4 4 4 4 0 0 0 0 0 0 0 0 0 0 0 0 
0 0 0 0 0 0 0 0 0 0 0 0 4 4 1 1 1 0 0 0 0 0 0 0 0 0 0 0 0 0 0 
0 0 0 0 0 0 0 0 0 0 0 0 4 4 1 1 1 0 0 0 0 0 0 0 0 0 0 0 0 0 0 
0 0 0 0 0 0 0 0 0 0 0 0 4 4 4 4 4 0 0 0 0 0 0 0 0 0 0 0 0 0 0 
0 0 0 0 0 0 0 0 0 0 0 0 0 0 4 4 4 0 0 0 0 0 0 0 0 0 0 0 0 0 0 
0 0 0 0 0 0 0 0 0 0 0 0 0 0 4 4 4 0 0 0 0 0 0 0 0 0 0 0 0 0 0 
0 0 0 0 0 0 0 0 0 0 0 0 0 0 4 4 4 0 0 0 0 0 0 0 0 0 0 0 0 0 0 
0 0 0 0 0 0 0 0 0 0 0 0 0 0 4 4 4 0 0 0 0 0 0 0 0 0 0 0 0 0 0 
0 0 0 0 0 0 0 0 0 0 0 0 0 0 0 0 0 0 0 0 0 0 0 0 0 0 0 0 0 0 0 
0 0 0 0 0 0 0 0 0 0 0 0 0 0 0 0 0 0 0 0 0 0 0 0 0 0 0 0 0 0 0