31
27
0 0 0 0 0 0 0 0 0 0 0 0 0 0 0 0 0 0 0 0 0 0 0 0 0 0 0
0 0 0 0 0 0 0 0 0 0 0 0 0 0 0 0 0 0 0 0 0 0 0 0 0 0 0
0 0 0 0 0 0 0 0 0 4 4 4 0 0 0 0 0 0 0 0 0 0 0 0 0 0 0
0 4 4 7 0 0 0 0 0 4 4 4 4 6 0 0 0 0 0 0 0 0 0 0 0 0 0
0 4 4 0 0 0 0 0 0 4 4 4 0 0 0 0 0 0 0 0 0 0 0 0 0 0 0
0 4 4 0 0 0 0 0 0 0 0 0 0 0 0 0 0 0 0 0 0 0 0 0 0 0 0
0 4 4 1 1 1 1 0 0 0 1 4 6 0 0 0 0 0 0 0 0 0 0 0 0 0 0
0 4 4 0 0 1 1 0 0 0 1 4 4 0 0 0 0 0 0 0 0 0 0 0 0 0 0
0 4 4 7 0 1 1 0 0 0 0 0 0 0 0 0 0 0 0 0 0 0 0 0 0 0 0
0 4 4 0 0 1 1 0 0 0 0 0 0 0 0 0 0 0 0 0 0 0 0 0 0 0 0
0 4 4 4 4 1 1 0 4 4 4 4 0 0 0 0 0 0 0 0 0 0 0 0 0 0 0
0 4 4 4 4 4 1 4 4 4 4 4 4 4 6 0 0 0 0 0 0 0 0 0 0 0 0
0 4 4 4 4 0 0 0 4 4 4 4 0 0 0 0 0 0 0 0 0 0 0 0 0 0 0
0 4 4 0 0 0 0 0 0 0 0 2 0 0 0 0 0 0 0 0 0 0 0 0 0 0 0
0 4 4 4 4 4 4 4 4 4 4 4 0 0 0 0 0 0 0 4 4 4 0 0 0 0 0
0 4 5 4 4 4 4 4 4 4 4 4 1 1 4 4 4 4 4 4 6 4 0 0 0 0 0
0 4 4 4 4 4 4 4 4 4 4 4 0 0 0 0 0 0 0 4 4 4 0 0 0 0 0
0 4 4 0 0 0 0 0 0 0 0 2 0 0 0 0 0 0 0 0 0 0 0 0 0 0 0
0 4 4 4 4 0 0 0 4 4 4 4 0 0 0 0 0 0 0 0 0 0 0 0 0 0 0
0 4 4 4 4 4 1 4 4 4 4 4 4 4 6 0 0 0 0 0 0 0 0 0 0 0 0
0 4 4 4 4 1 1 0 4 4 4 4 0 0 0 0 0 0 0 0 0 0 0 0 0 0 0
0 4 4 0 0 1 1 0 0 0 0 0 0 0 0 0 0 0 0 0 0 0 0 0 0 0 0
0 4 4 7 0 1 1 0 0 0 0 0 0 0 0 0 0 0 0 0 0 0 0 0 0 0 0
0 4 4 0 0 1 1 0 0 0 1 4 4 0 0 0 0 0 0 0 0 0 0 0 0 0 0
0 4 4 1 1 1 1 0 0 0 1 4 6 0 0 0 0 0 0 0 0 0 0 0 0 0 0
0 4 4 0 0 0 0 0 0 0 0 0 0 0 0 0 0 0 0 0 0 0 0 0 0 0 0
0 4 4 0 0 0 0 0 0 4 4 4 0 0 0 0 0 0 0 0 0 0 0 0 0 0 0
0 4 4 7 0 0 0 0 0 4 4 4 4 6 0 0 0 0 0 0 0 0 0 0 0 0 0
0 0 0 0 0 0 0 0 0 4 4 4 0 0 0 0 0 0 0 0 0 0 0 0 0 0 0
0 0 0 0 0 0 0 0 0 0 0 0 0 0 0 0 0 0 0 0 0 0 0 0 0 0 0
0 0 0 0 0 0 0 0 0 0 0 0 0 0 0 0 0 0 0 0 0 0 0 0 0 0 0